 ______ ______________
|   |_  | | |   |_  | |
| | | |__ | | | | |__ |
| | ____| | | | ____| |
| | | __|   | | | __| |
| |_______| | |_______|
| |_   ___| |_  | ___ |
|_  | |   | |_| | | | |
| |_  |_  |   |  _| | |
| |_|   |_| |   |___|p|
|___________|_________|
