 ___________________________
|  _______________   ___    |
| |               | |   | | |
| |  _____________  |     | |
| | |___   ___   ___|   | | |
| |___c_| |   | |_c_____| | |
|  _____  |   |  _________| |
| |     | |___| |    _____ c|
| |     | |c__  |___|    _|_|
| |_____| |   |_   _____| | |
|    _____|_____| |______ | |
| | |_____________      |_| |
| |       |c_______ |       |
| |_______________|p|c______
|___________________________|
