 _____________________
|e  |_  | | |   |_  |c|
| | | |c_ | | | | |__ |
| | ____| | | | ____| |
| | | __|   | | | __| |
| |_______| | |l______|
| |_   __l| |e  | ___ |
|_ c| |   | |_| | | |  
|  _  |   |   |   | | |
|p| |   |  c|  _| | | |
| |_| |___| | |___|_| |
|____ |   | | ____|e__|
|c___ |__________ __|c|
|_________|___________|
