 _____________________
|e  |_  | | |   |_  |c|
| | | |c_ | | | | |__ |
| | ____| | | | ____| |
| | | __|   | | | __| |
| |_______| | |_______|
| |_   ___| |e  | ___ |
|_ c| |   | |_| | | |  
|  _  |   |   |   | | |
|p| |   |  c|  _| | | |
| |_| |___| | |___|_| |
|____ |   | | ____| __|
|c___ |__________ __|c|
|_________|___________|
