 ___________________________
|h _______________   ___    |
| |              e| |l l| | |
| |  _____________  |     | |
| | |___   ___   ___|   | | |
| |___c_| |   | |_c____e| | |
|  p____  |   |  _________| |
| |     | |___| |    _____ c|
| |     | |c__  |___|    _|_|
| |____e| |   |_   _____| | |
|    _____|_____| |______ | |
| | |_____________     l|_| |
| |       |c_______ |       |
| |e______________| |_______
|___________________________|
